2 1 1 1 1 1 1 1 1 1 1 1 1 1 1 1 1 1 1 1 1 1 1 1 1 1 1 1 1 51
2 1 1 1 1 1 1 1 1 1 1 1 1 1 1 1 1 1 1 1 1 1 1 1 1 1 1 1 1 51
2 1 1 1 1 1 1 1 1 1 1 1 1 1 1 1 1 1 1 1 1 1 1 1 1 1 1 1 1 51
2 1 1 1 1 1 1 1 1 1 1 1 1 1 1 1 1 1 1 1 1 1 1 1 1 1 1 1 1 51
2 3 3 3 3 3 3 3 3 3 3 3 3 3 3 3 3 3 3 3 3 3 3 3 3 3 3 3 3 51
2 3 3 3 3 3 3 3 3 3 3 3 3 3 3 3 3 3 3 3 3 3 3 3 3 3 3 3 3 51
2 3 3 3 3 3 3 3 3 3 3 3 3 3 3 3 3 3 15 15 15 15 3 3 3 3 3 3 3 51
2 3 3 3 3 3 3 3 3 3 3 3 3 3 3 3 3 15 22 21 21 20 15 3 3 3 3 3 3 51
2 3 3 3 5 3 5 3 3 3 3 3 3 3 3 3 3 15 23 24 24 19 15 3 3 3 3 3 3 51
2 3 3 3 4 3 4 3 3 3 3 3 3 3 3 3 3 15 16 17 17 18 15 3 3 3 3 3 3 51
2 3 3 3 3 3 3 3 3 3 3 3 3 3 3 3 3 3 15 15 15 15 3 3 3 3 3 3 3 51
2 3 3 3 5 3 5 3 3 3 3 3 3 3 3 3 3 3 3 3 3 3 3 3 3 3 3 3 3 51
2 3 3 3 4 3 4 3 3 3 3 3 3 10 11 11 12 3 3 3 3 3 3 3 3 3 3 3 3 51
2 3 3 3 3 3 3 3 3 3 3 3 3 9 14 14 13 3 3 3 3 3 3 3 3 3 3 3 3 51
2 3 3 3 3 3 3 3 3 3 3 3 3 9 14 14 13 3 3 3 3 3 3 3 3 3 3 3 3 51
2 1 1 1 1 1 1 1 1 1 1 1 1 1 25 25 1 1 1 1 1 1 1 1 1 1 1 1 1 51
