36 36 36 36 36 36 36 36 36 36 36 36 36 36 36 36 36 36 36 36 36 36 85 52 52 52 52 52 52 67
36 36 36 36 36 85 82 83 83 83 84 86 36 36 36 36 36 36 85 82 83 83 84 52 64 65 52 52 52 67
83 83 83 83 83 84 77 79 79 79 81 86 36 36 36 36 36 36 85 77 79 79 81 52 62 63 52 52 52 67
77 79 79 79 79 81 76 78 78 78 80 82 83 83 83 83 83 83 84 77 79 79 81 52 52 52 52 52 52 67
77 79 75 79 79 81 52 52 52 52 52 77 79 79 79 79 79 79 81 76 78 78 80 52 52 52 52 64 65 67
76 78 74 78 78 80 52 52 52 52 52 77 79 79 79 75 79 79 81 52 52 52 52 52 52 52 52 62 63 67
67 87 88 89 52 52 52 52 53 53 52 76 78 78 78 74 78 78 80 36 52 52 52 52 52 52 52 52 52 67
67 52 52 52 53 53 53 53 53 53 53 36 36 36 69 71 73 36 36 36 53 53 53 53 53 53 53 52 52 67
35 53 53 53 53 53 60 61 53 53 53 53 36 36 68 70 72 36 36 53 53 53 53 53 53 60 61 53 53 35
35 53 53 53 53 53 58 59 53 53 53 36 36 36 36 36 36 36 36 53 53 53 53 53 53 58 59 53 53 35
35 53 53 53 27 53 53 53 53 53 53 53 36 36 36 36 36 36 36 53 53 53 53 53 53 53 53 53 53 35
35 53 27 53 27 53 53 27 27 53 53 53 36 36 36 36 36 36 27 53 27 53 53 27 53 53 53 53 53 35
35 27 27 27 27 27 27 56 57 53 27 53 27 36 36 36 36 36 27 27 27 27 53 27 27 53 27 53 53 35
35 27 56 57 27 27 27 54 55 27 27 53 27 36 36 36 36 36 36 27 27 27 27 56 57 27 27 27 53 35
35 27 54 55 27 27 27 27 27 27 27 27 36 36 36 36 36 36 36 27 27 27 27 54 55 27 27 27 27 35
35 35 35 35 35 35 35 35 35 35 35 35 35 66 66 66 66 66 35 35 35 35 35 35 35 35 35 35 35 35
